@@@@@@@@@
@@@@@@@@@
@@@..@@@@
@@@.x#.@@
@@.##..@@
@@.@x.x@@
@@m..@@@@
@@@@@@@@@
@@@@@@@@@
