@@@@@@@@@
@@@@@@@@@
@@mX..@@@
@@.#@..@@
@@.#.x.@@
@@x...@@@
@@@@@@@@@
@@@@@@@@@
