@@@@@@@@@
@@@@@@@@@
@@@...@@@
@@@.@x@@@
@@..#x@@@
@@.@.#.@@
@@..X.m@@
@@@@@@@@@
@@@@@@@@@
