@@@@@@@@@@@
@@@@@@@@@@@
@@...x@@@@@
@@.@@#@@@@@
@@.#...@@@@
@@.@#..Xx@@
@@x.m@...@@
@@@@@@@@@@@
@@@@@@@@@@@
