@@@@@@@@@@
@@@@@@@@@@
@@@@..M@@@
@@@@.##@@@
@@@@#...@@
@@@@.x@.@@
@@.x.X..@@
@@..#x@@@@
@@@@@@@@@@
@@@@@@@@@@
