@@@@@@@@@
@@@@@@@@@
@@@x..@@@
@@M###.@@
@@.@..x@@
@@....@@@
@@@@@@@@@
@@@@@@@@@
