@@@@@@@@@
@@@@@@@@@
@@m..@@@@
@@.###.@@
@@@.xxx@@
@@...@.@@
@@.....@@
@@@@@@@@@
@@@@@@@@@
