@@@@@@@@@
@@@@@@@@@
@@@..@@@@
@@@....@@
@@.#x.x@@
@@.@##.@@
@@m.x@@@@
@@@@@@@@@
@@@@@@@@@
