@@@@@@@@@@@
@@@@@@@@@@@
@@....@@@@@
@@.@@.@@@@@
@@.x.X.@@@@
@@@.#.X..@@
@@@..@..m@@
@@@@@@@@@@@
@@@@@@@@@@@
