@@@@@@@@@@@
@@@@@@@@@@@
@@@@m..@@@@
@@@@.@.@@@@
@@..x#X#.@@
@@.@...@.@@
@@..x@...@@
@@@@@@@@@@@
@@@@@@@@@@@
