@@@@@@@@@@
@@@@@@@@@@
@@@@..@@@@
@@@@...@@@
@@@@x#..@@
@@@@x.@.@@
@@..##..@@
@@..M@@@@@
@@@@@@@@@@
@@@@@@@@@@
