@@@@@@@@@
@@@@@@@@@
@@@@@.m@@
@@@x##x@@
@@..#.@@@
@@.@.x@@@
@@.#.x@@@
@@@@@@@@@
@@@@@@@@@
