@@@@@@@@@
@@@@@@@@@
@@...@@@@
@@.@#.@@@
@@x.X..@@
@@.#@..@@
@@M.X..@@
@@@@@@@@@
@@@@@@@@@
