@@@@@@@@@@
@@@@@@@@@@
@@@..@@@@@
@@M...@@@@
@@.@#...@@
@@..##..@@
@@@x.x@@@@
@@@@@@@@@@
@@@@@@@@@@
