@@@@@@@@@
@@@@@@@@@
@@@m..@@@
@@..@..@@
@@.#X#.@@
@@..x..@@
@@@.x.@@@
@@@@@@@@@
@@@@@@@@@
