@@@@@@@@@@
@@@@@@@@@@
@@m.X.@@@@
@@.@....@@
@@x##x@.@@
@@......@@
@@@@@@@@@@
@@@@@@@@@@
