@@@@@@@@@
@@@@@@@@@
@@...@@@@
@@x...@@@
@@.@x#.@@
@@.##@.@@
@@@mx..@@
@@@@@@@@@
@@@@@@@@@
