@@@@@@@@@
@@@@@@@@@
@@..@@@@@
@@...@@@@
@@#.#m@@@
@@x.@#.@@
@@..x.x@@
@@@@@@@@@
@@@@@@@@@
