@@@@@@@@@@@
@@@@@@@@@@@
@@@...@@@@@
@@@x.x.@@@@
@@m#.X.#.@@
@@.@..@@.@@
@@..X....@@
@@@@@@@@@@@
@@@@@@@@@@@
