@@@@@@@@@
@@@@@@@@@
@@@..@@@@
@@@#x..@@
@@.....@@
@@.@XX.@@
@@m..@@@@
@@@@@@@@@
@@@@@@@@@
