@@@@@@@@@@@
@@@@@@@@@@@
@@....@@@@@
@@.@@X@@@@@
@@...X.@@@@
@@@...#..@@
@@@.m@x..@@
@@@@@@@@@@@
@@@@@@@@@@@
