@@@@@@@@@
@@@@@@@@@
@@...@@@@
@@.@.@@@@
@@x.##.@@
@@x..@.@@
@@..Xm.@@
@@@@@@@@@
@@@@@@@@@
