@@@@@@@@@
@@@@@@@@@
@@xmX.@@@
@@#..#.@@
@@...@.@@
@@..x..@@
@@@@@@@@@
@@@@@@@@@
