@@@@@@@@@@
@@@@@@@@@@
@@@...@@@@
@@.x@.#m@@
@@..@.@.@@
@@.X..#x@@
@@....@@@@
@@@@@@@@@@
@@@@@@@@@@
