@@@@@@@@@@@
@@@@@@@@@@@
@@...x.@@@@
@@.@@...@@@
@@..#X@..@@
@@@#.....@@
@@@.x@..m@@
@@@@@@@@@@@
@@@@@@@@@@@
