@@@@@@@@@@
@@@@@@@@@@
@@@m..@@@@
@@@#@#@@@@
@@.x.x..@@
@@.@..#.@@
@@..x.@@@@
@@@@@@@@@@
@@@@@@@@@@
