@@@@@@@@@@
@@@@@@@@@@
@@@@@.x.@@
@@.m#...@@
@@...XX.@@
@@....@@@@
@@@@@@@@@@
@@@@@@@@@@
