@@@@@@@@@@
@@@@@@@@@@
@@....@@@@
@@.m@#..@@
@@.Xx#..@@
@@.x.@..@@
@@@@@@@@@@
@@@@@@@@@@
