@@@@@@@@@@
@@@@@@@@@@
@@....@@@@
@@...xx.@@
@@.###m.@@
@@..@.x.@@
@@@@@@@@@@
@@@@@@@@@@
