@@@@@@@@
@@@@@@@@
@@m..@@@
@@x#X.@@
@@..@.@@
@@....@@
@@@@@@@@
@@@@@@@@
