@@@@@@@@@
@@@@@@@@@
@@@@..@@@
@@m.x#@@@
@@...#.@@
@@.@x..@@
@@.....@@
@@@@@@@@@
@@@@@@@@@
