@@@@@@@@@
@@@@@@@@@
@@mx@@@@@
@@##...@@
@@x#.@.@@
@@..x..@@
@@@@@@@@@
@@@@@@@@@
