@@@@@@@@@
@@@@@@@@@
@@.x#m@@@
@@.x##x@@
@@#..@.@@
@@x....@@
@@@@@@@@@
@@@@@@@@@
