@@@@@@@@@@
@@@@@@@@@@
@@x.x@@@@@
@@##....@@
@@m#@...@@
@@.x....@@
@@@@@@@@@@
@@@@@@@@@@
