@@@@@@@@@
@@@@@@@@@
@@@x..@@@
@@Xx@.@@@
@@x#.#.@@
@@#..@.@@
@@...Xm@@
@@@@@@@@@
@@@@@@@@@
