@@@@@@@@@
@@@@@@@@@
@@m.xx@@@
@@.@#.@@@
@@.@...@@
@@..#@.@@
@@..X..@@
@@@@@@@@@
@@@@@@@@@
