@@@@@@@@@@
@@@@@@@@@@
@@@.x#m@@@
@@@.X##.@@
@@.x....@@
@@.@.@..@@
@@..x@@@@@
@@@@@@@@@@
@@@@@@@@@@
