@@@@@@@@@@
@@@@@@@@@@
@@@m..@@@@
@@x#X#..@@
@@.@...x@@
@@....@@@@
@@@@@@@@@@
@@@@@@@@@@
