@@@@@@@@@@
@@@@@@@@@@
@@xxx.@@@@
@@.m@#..@@
@@.#.#..@@
@@...@..@@
@@@@@@@@@@
@@@@@@@@@@
