@@@@@@@@@
@@@@@@@@@
@@...@@@@
@@.@.@@@@
@@Xx#..@@
@@..@#.@@
@@m...x@@
@@@@@@@@@
@@@@@@@@@
