@@@@@@@@@
@@@@@@@@@
@@...m@@@
@@..@X.@@
@@...#.@@
@@..#xx@@
@@@@@@@@@
@@@@@@@@@
