@@@@@@@@@@
@@@@@@@@@@
@@@x.@@@@@
@@@x#..x@@
@@x#..@.@@
@@.@##..@@
@@m..@@@@@
@@@@@@@@@@
@@@@@@@@@@
