@@@@@@@@@
@@@@@@@@@
@@..x.@@@
@@.@x.@@@
@@..x..@@
@@.###.@@
@@..@.m@@
@@@@@@@@@
@@@@@@@@@
