@@@@@@@@@@
@@@@@@@@@@
@@@..@@@@@
@@@.X.x.@@
@@.#..@.@@
@@.@.#..@@
@@m.x@@@@@
@@@@@@@@@@
@@@@@@@@@@
