@@@@@@@@@
@@@@@@@@@
@@@@M.@@@
@@..##.@@
@@.@#..@@
@@x...x@@
@@@@@@@@@
@@@@@@@@@
