@@@@@@@@@@
@@@@@@@@@@
@@@x...@@@
@@..###M@@
@@.@.@..@@
@@x....@@@
@@@@@@@@@@
@@@@@@@@@@
