@@@@@@@@@@
@@@@@@@@@@
@@m.x@@@@@
@@.X.#..@@
@@.#@.@.@@
@@...x..@@
@@@@@@@@@@
@@@@@@@@@@
