@@@@@@@@@
@@@@@@@@@
@@.#xm@@@
@@..#..@@
@@..#@.@@
@@.xXx.@@
@@@@@@@@@
@@@@@@@@@
