@@@@@@@@@@
@@@@@@@@@@
@@.....@@@
@@.@m@..@@
@@x###x.@@
@@...@x.@@
@@@@@@@@@@
@@@@@@@@@@
