@@@@@@@@@@
@@@@@@@@@@
@@..x..@@@
@@.##@x.@@
@@.@m#..@@
@@..x@..@@
@@@@@@@@@@
@@@@@@@@@@
