@@@@@@@@@
@@@@@@@@@
@@.x#.@@@
@@...#M@@
@@#..@.@@
@@x.x#.@@
@@@@@@@@@
@@@@@@@@@
