@@@@@@@@@@
@@@@@@@@@@
@@@@...@@@
@@@@...@@@
@@@@.#..@@
@@@@#x@.@@
@@..#X..@@
@@xx.m@@@@
@@@@@@@@@@
@@@@@@@@@@
