@@@@@@@@@
@@@@@@@@@
@@@@..m@@
@@x.X@.@@
@@...#.@@
@@.#x.@@@
@@@@@@@@@
@@@@@@@@@
