@@@@@@@@@@
@@@@@@@@@@
@@@m.@@@@@
@@@##...@@
@@..#.@.@@
@@.@.xxx@@
@@...@@@@@
@@@@@@@@@@
@@@@@@@@@@
