@@@@@@@@@
@@@@@@@@@
@@@..x@@@
@@@.@#@@@
@@.#..@@@
@@.@.#x@@
@@.x..m@@
@@@@@@@@@
@@@@@@@@@
