@@@@@@@@@@@
@@@@@@@@@@@
@@x#xx@@@@@
@@.@@.#.@@@
@@...#.#x@@
@@..@..#.@@
@@...x@.m@@
@@@@@@@@@@@
@@@@@@@@@@@
