@@@@@@@@@
@@@@@@@@@
@@m...@@@
@@.##..@@
@@.@x.x@@
@@.....@@
@@@@@@@@@
@@@@@@@@@
