@@@@@@@@@
@@@@@@@@@
@@@m..@@@
@@.#X#.@@
@@x..@.@@
@@.@x..@@
@@....@@@
@@@@@@@@@
@@@@@@@@@
