@@@@@@@@@@
@@@@@@@@@@
@@m...@@@@
@@.x#X.@@@
@@.@#x..@@
@@......@@
@@@@@@@@@@
@@@@@@@@@@
