@@@@@@@@@
@@@@@@@@@
@@x..@@@@
@@.@.#.@@
@@..X..@@
@@..@@.@@
@@.X..m@@
@@@@@@@@@
@@@@@@@@@
