@@@@@@@@@@
@@@@@@@@@@
@@@@..@@@@
@@..x.x.@@
@@.@x#@.@@
@@m#..#.@@
@@@@..@@@@
@@@@@@@@@@
@@@@@@@@@@
