@@@@@@@@@@
@@@@@@@@@@
@@x.....@@
@@.@@.@.@@
@@.XmX..@@
@@@##x@@@@
@@@....@@@
@@@x#..@@@
@@@@@@@@@@
@@@@@@@@@@
