@@@@@@@@@@
@@@@@@@@@@
@@..x@@@@@
@@.x.#..@@
@@..@#@.@@
@@...x#m@@
@@@@@@@@@@
@@@@@@@@@@
