@@@@@@@@
@@@@@@@@
@@m..x@@
@@###.@@
@@x.@.@@
@@..x.@@
@@@@@@@@
@@@@@@@@
