@@@@@@@@@
@@@@@@@@@
@@mX..@@@
@@###..@@
@@x..@.@@
@@...xx@@
@@@@@@@@@
@@@@@@@@@
