@@@@@@@@@@
@@@@@@@@@@
@@m.xx.@@@
@@.#.@..@@
@@.@##..@@
@@...@..@@
@@x..@..@@
@@@@@@@@@@
@@@@@@@@@@
