@@@@@@@@@@
@@@@@@@@@@
@@..x..@@@
@@.#.@.@@@
@@x@#.#.@@
@@..x@m.@@
@@...@..@@
@@@@@@@@@@
@@@@@@@@@@
