@@@@@@@@@@
@@@@@@@@@@
@@m....@@@
@@.@.@#.@@
@@x.#X..@@
@@...@.x@@
@@@@@@@@@@
@@@@@@@@@@
