@@@@@@@@@@
@@@@@@@@@@
@@@@..@@@@
@@@@...@@@
@@@@#...@@
@@@@.x@.@@
@@.X#x.m@@
@@....@@@@
@@@@@@@@@@
@@@@@@@@@@
