@@@@@@@@@@
@@@@@@@@@@
@@@m.x@@@@
@@.###..@@
@@.@x...@@
@@.x..@@@@
@@@@@@@@@@
@@@@@@@@@@
