@@@@@@@@@@@
@@@@@@@@@@@
@@@...@@@@@
@@@.@x.x.@@
@@xX#..@x@@
@@x#..#..@@
@@##@@...@@
@@m.@@@@@@@
@@@@@@@@@@@
@@@@@@@@@@@
