@@@@@@@@@@
@@@@@@@@@@
@@@..x.@@@
@@...##m@@
@@.@x.#.@@
@@..x@..@@
@@@@@@@@@@
@@@@@@@@@@
