@@@@@@@@@@@
@@@@@@@@@@@
@@....@@@@@
@@.@@.@@@@@
@@.x#mx@@@@
@@@.##...@@
@@@..@x..@@
@@@@@@@@@@@
@@@@@@@@@@@
