@@@@@@@@@@
@@@@@@@@@@
@@@@x...@@
@@@@....@@
@@@@#.x@@@
@@...@x@@@
@@.###x@@@
@@m.x#.@@@
@@@@@@@@@@
@@@@@@@@@@
