@@@@@@@@@@
@@@@@@@@@@
@@@....@@@
@@.xx...@@
@@.@.###@@
@@...@mx@@
@@@@@@@@@@
@@@@@@@@@@
