@@@@@@@@@
@@@@@@@@@
@@..@@@@@
@@...Xx@@
@@..#@.@@
@@..x#m@@
@@@@@@@@@
@@@@@@@@@
