@@@@@@@@@@@
@@@@@@@@@@@
@@....@@@@@
@@.@@.@@@@@
@@..Xx.@@@@
@@@#..#..@@
@@@x.@..m@@
@@@@@@@@@@@
@@@@@@@@@@@
